11111111111111
1ECCCC00000001
10000000001001
10000010000001
101000P0000001
11111111111111